50 50
11000100010111110000010101111111111111111111111111
11110111010111111111010101111111111111111111111111
01000001000100010001000100000111111111111111111111
01111101010101110111011101011111111111111111111111
01010000010000000001000101000100011111111111111111
01011101010101110111011101110111011111111111111111
00010001010101010000010001000000000101111111111111
11010111010101011111010101110101111101111111111111
11010100000101000000000101000101000001111111111111
11010101011101010101111111010111110111111111111111
00000001000001010101000000010000000111110111111111
11111111010101010111110111110111010111110111111111
01010001010100000111110100000100010000000001011111
01011101010111011111111111011111110101110101011111
00010000010100000100000000010100010101110100011111
01111101111111011111111111010101110101110111011111
00000100000000010111110001000001000101110111011101
11110101110111110111111101011111111111110111111101
00000000000111000000011100000101000000010100010001
01010111011111111101011111010101111101110101111101
01010000010001110101000000010001000000000001010101
11110101111101110111011101010101011101110111010101
11110100000000010100011100000101011100000000000001
11110101011101010111111111010101111111111111010101
11110101000001000001111111010100000111002100010101
11111101011111111101111111010101111111010101110111
11111101000000010000011100010000010000010000000111
11111101011101110111011111011111010101111101011111
11000001011100000100010000000111010001000101000111
11111111111111011111011111110111010111110101110111
11111101000100000100011111110111000100000000010111
11111101110101011111111111110111111111010101010111
01110101010101000000011111110111011111010101000111
01110101010101011101111111110111011111010111011111
01010001000001000001010000000111010000010111000001
01011101011101111111010111110111011111011111011111
00000100000000010001010101010000011111000001000111
11010101011111010101011101011101011111111101011111
11010001010001010100010101000001011111111101011111
11011111110111011111010101111111011111111101111111
00010101010000000100000000000001000111111101111111
01110101011101010101111111010101110111111101111111
01110000000001010100000100010100010001111101111111
11111111011101010101111101010111010111111111111111
11111100010001000100010001000100000001111111111111
11111101110101110101110101110111111101111111111111
11000000030101110101000100000000011101111111111111
11111111011101110111110101110111111111111111111111
11111111010001000100000001000111111111111111111111
11111111111111111111111111111111111111111111111111
