50 50
11111111111111111111111111111111111111111111111111
10000010111110100000000000000010000010100000000000
10101010111110111010101010101010101010111110101011
10100010001000100010001000000000000000111000001000
10111010111011101110111010101011101010111010111111
10100010000000000000000000000000000010000000111111
10101011101010101110101010101011101111111110111111
10101000001000101000000000000000000011111110111111
10111011101110111110101010101111111011111111111111
10111000000010000000000000000000100000100011111111
10111111111011101010101110111010111011101111111111
10000011111000000010000010101000000000001111111111
10101111111111101010101011101011101010101111111111
10100000000000101000001010101000000000100011111111
10111110111011101010101010101111111010111111111111
10000000000010001010101000000000111000001110100000
11111110101011111010111011111011111110101110101110
10000000001010111000001011111010000010101000001110
11111110101010111011101111111111101010101011101110
10000000001010111000000011111000103000000000000000
11111011101110111110111011111010111111101010101111
11111010100000100000111011111010000000000000000000
11111110111111111010111111111110101010101010101011
11111110001110100000100000000210000000001000000000
11111111101110111010101110101110111111111010101011
11111111100010100000000000001010000000100000101000
11111111101010111110101010111011111010111010111010
11111111101000100000001000000000001000111010000000
11111111111010101010101010111111111010111111101011
11111110111000101010000000101010000010000000000011
11111110111011101010101010101011101110111011111011
11111110000000100000101010001000000010111000000000
11111110111010111010101111101110101010111111101111
11111110101000000010001110101010001010111110000000
11111110101110101010101110101010101010111110101011
11111110000000001010100010100010100010101000001000
11111111101111111010111010101011101011101110101011
11111111100010000010000010000011100000001000101011
11111111101111111011101010101011111010101110101111
11111110001000111000000000001000100000101000100011
11111110101010111010111010111011101110111111101111
11111110100010000000100000100011100010000010000011
11111111101011101011111011101111111111101010101111
11111111100000001011111000101111111000001010100011
11111111101110111111111011111111111010111011111111
11111000001000001111111011111111111010000000001011
11111111111011101111111011111111111010101111101011
11111111111000001111111000111111111010100000001000
11111111111110101111111011111111111011111110101010
11111111111110100011111000000000111011111110000010
