50 50
11111111111111111111111111111111111111111111111111
11101110100011100000000010000011111010000000100000
11101110101011101111101010101111111010101111101010
10100010000010000011100000001000100000000010000010
10101010101111101111111110101011111011111110101111
10100000000010001010000000100000000000001010100000
10101010111110101010111110101011111111101010101011
10000000001110001000111000001000000011101000001000
10111010101110111011111111101011101111111111101011
10000010001000101010111110000000101000101000001011
11101010101010101010111110101010111110101110101111
10000000000010000010100010000000000010001000001111
11111111101111111010111010111010101010111111101111
11111000000000001010000000000000100000000000101011
11111011101010101111111010111010101011101011101011
11100010000000001010000000100010001010000000001010
11111110101110101010111111101111111010101011111010
10101000100000000010000000000010000010000000001000
10101110101110101010111111101110111111111110101010
10000010001110001010000000101000001111111110100000
11101010101111101011101110111011101111111111111010
10001000001111100011101010100010001011111010000000
10111110101111111011111010111110111011111010101010
10000000101000001000000000000000000011111000100000
11111010101111101011111110101111111111111010101111
10100000101111100000100000300000111110100000001111
10101011111111111111111110101010111110111010111111
10000000000011111111111110100010001110100010111111
10101011111111111111111110111010111110101010111111
10000011111111111111111000001000000010000010000011
10111111111111111111111011111010101011101111101011
10001000001111111111111000100010001010101010000011
10101010111111111111111010111110101110111011111011
10101010101111111111100010100010000000100000101000
10101011101111111111111111111011101110111011101110
10000010000000111110000010100000000010000000100010
10101010111111111110101010111111101010101011111010
10000000100000111010100000100000000010101000000000
10101011101110111010101010101010111011101010111010
10100000101010000000000010000000100000100000001010
10111010101011101010101010101010111110101010111010
10000000000000000000000010100010001010101002000000
10101110111010101111111010111111101010111011111110
10000000000000000000000000100000101000100011111110
11111111101010111110111010101010111010101111111111
11100000000000001000000000100000000010001111111111
11111011111010111010111010111111111011111111111111
11111000100010000000000000000011100000001111111111
11111110101010101010101111101111111111101111111111
11111000100000000000101111100000111000001111111111
