10 10
1111111111
1210001000
1010101010
1000100010
1011111110
1000000030
1011011010
1000000000
1011101111
1000000000
